XXXXXXXXXX
XP......X
X.XXXX..X
X.......X
XXXXXXXXXX